# Level 1 Data

VEEEMEEEEEVVVVV
VEEGGEEGEEVEMEE
VMEGGEEGEEVEEEE
VMEGGEEGMEVEGGG
VEEGGMEGEEVEGGG
VVEGGEEGEEVEGGG
EVEEEEMEMEVEEEE
EVVVVEEEEEVEEEE
GEEEVEEEEEVEEEG
GGEEVVVPVVVEEGG