# Level 3 Data

VVMGGGGMGGGGMVV
GVEEGGGGGGGEEVG
GVVVEGGGGGEVVVG
GEEVEEGGGEEVEEG
EEEVVVEGEVVVEEE
EEMEEVEMEVEEMEE
EEGEEVGGGVEEGEE
EGGGEVVVVVEGGGE
GGGGGEGVGEGGGGG
GGGGGEGPGEGGGGG