# Level 3 Data

VVVVVMEMEMVVVVV
EGGEVEGEGEVEMME
GEEEVEGEGEVEGGE
EMMEVEGEGEVGGGG
GGGGVEGEGEVGGGG
GGGGVVVVVVVEGGE
EGGEEGEVEGEEGGE
EGGEEGEVEGEEEEE
GEEEEGEVEGEEEEG
GGEEEGEPEGEEEGG