# Level 2 Data

VVVVVVEEMEMEEVV
EGGEEVEEEEEEEVE
EGGEEVEGGGGGEVE
MGGMEVEGGGGGEVE
GGGGEVEEEEEEEVE
GGGGEVEMEEVVVVE
EGGEEVEGGEVEEEE
EMMEEVGGGGVEGGE
GEEEEVEGGEVEGGE
GGEEEVVPVVVEEEE